1111111111111111111111111111111111111
100000X0C000000001100000C0C0000001111
1001011111000001111001011111010001111
10010000C0000P000000010000C0100001111
1001000000000E01111001000000100001111
10001111101100000C00001111100C00C0001
1111111111111111111111111111111111111