111111
1P0CE1
11X111
111111