1111111111111111111111111111111111111
1CCCCCXCCCCCCCCCC11CCCCCCCCCCCCCC1111
1CC1C11111CCCCC1111CC1C11111C1CCC1111
1CC1CCCCCCCCCPCCCCCCC1CCCCCC1CCCC1111
1CC1CCCCCCCCCEC1111CC1CCCCCC1CCCC1111
1CCC11111C11CCCCCCCCCC11111CCCCCCCCC1
1111111111111111111111111111111111111