11111111
1P000001
10C0C1E1
11111111