1111111111111111111111111111111111111111111111
1C00000000000010000000100000001000000010000001
1000000000000000000C0011000000000000000000C001
1101110000111100C0000001101110000111100C000001
1E00000000111100000000100000000111100000000001
1111111100011100P00000011111111000111000000001
100000000000010000000001000C00C000001000000001
10C0000000000100000000110C00000000001000000001
1101110000111100000C0000001110000111100000C001
10000000000C0000000000010000000000C00000000001
1111111111111111111111111111111111111111111111