1111111111111111111111111111111111111
100000X0C000000001100000C0C0000001111
1001011111000001111001011111000001111
10010000C0000P000000010000C0000001111
1001000000000E01111001000000000001111
10001111101100000C00001111101100000C1
1111111111111111111111111111111111111
