1111111111111111111
1CCCCXCCCCCCCCC1111
1CC1C11111CCCCC1111
1CC1CCCCCCCCCPC1111
1CC1CCCCCCCCCEC1111
1CCC11111C11CCCCCC1
1111111111111111111